

WWWWWW
W   WW
W    W
WW   W
WWW  W
WWWW W
WWWWWW

Player 3 3
