18 20
WWWWWWWWWWWWWWWWWWWW
W W            WWWWW
W W WWWWWWWWWW     W
W      W     WWWWW W
WW W W  WW W W     W
WW W WW  W W WWWWWWW
WW W WWW W W W     W
WW W WWW W WWW WWW W
W  W   W W   W W W W
W WW   W W   W W W W
W W  W W WWW W W W W
W W  W W   W W W W W
W WW W WWW W W W W W
W  W W   W W W W W W
WW W  WWWW W W W W W
WW WW    W W W   W W
WW    WWW      WWW W
WWWWWWWWWWWWWWWWWWWW

Player 1 1
Exit 16 18

# A simple maze level.